ooooooooo          ooooooooooooooooooooooooooooooooooooooooooooooooooooooooooooooooooooooooooooooooooooooooooooooooooooooooooooooooooooooooooooooooooooooooo
e                                                                                                                                                   ee     e
e                                                                                                                                                   ee   - e
e                                                                                                                                                       ee e
e                                                                                                                                                   ee     e
e                                                                                                                                                   eee    e
e                   +                                    #                  #                           +                                           ee     e
e                   ee                                  eeeeeeeeeeeee ^ eeeeeeeeee      ee   #          e                                                  e
e               ee                                  ee                -     e                   ee          e                                           ee e
e   !       ee                                  ee                      e                    eee      - e                                       ?   ee     e
e       ee      -               -        >   ee                             e                          e    e>       ^    ^    ^                        ee e
oooooooooooooooooooooooo   ^  oooo  ^   ooooooooooooooooooooooooooooooooooo                      oooooooooooooooooo  ooo  ooo  oooooooooooooeeeeeeeeeeeeeeee