e                                                                                                                                                                                                          e
e>     o                                                                                                                       ooo                                                                         e
ee   eee                                   oo                                                                                   !                         o                    -                           e
e     e                                                                                                                                                            oo         ooo                          e
e  ?  e   o                                        oo    >         >       >        >    #                                    ooooo                       #          o               o      +              e
e     e      oo                            oo         >ooo#####oo#####oo####ooo#####oo   >        o                      o                 o        oo    #    oo                          oo              e
eeeee #    ^      o                                                                                                                                                                     >                  e
e  >           ^^                  o                                                    o                   o  >   ^      >  ^    >   ^^  >                            oo      o    o   >                  e
e                    ^^ooo                      oo                                            oo                                                o         #                             oo                 e
e     #                                                                                              o                                          o         #                                    o       o + e
e  -  #                                                o   >   o  >   o  >  o   >   oo    +                                     -               o  ^^  ^^ #   ^^  - ^^ +  ^^^ +  ^^^             ^^  ^^o   e
eeeeeeeeeeeeeeeeeeeeeeeeeeeeeeeeeee            eeeeeeeeeeeeeeeeeeeeeeeeeeeeeeeeeeeeeeeeeeeeeeeeeeeeeeeeeeeeeeeeeeee   ooo      ooo      ooo     eeeeeeeeeeeeeeeeeeeeeeeeeeeeeeeeeeeeeeeeeeeeeeeeeeeeeeeeeeee
